$ $ $ 4 5 $ 8 9 $
$ $ $ $ 8 9 $ 3 $
$ 9 7 $ $ $ 5 $ $
7 $ $ $ $ 1 4 $ $
3 $ 5 $ 4 2 $ $ $
4 $ $ 9 $ $ $ 1 5
$ 4 2 3 $ $ 9 $ $
$ 5 $ $ $ $ $ 4 2
$ $ $ 2 1 $ $ $ 3

$ $ $ $ 5 6 $ $ 1
2 $ 1 $ $ 9 $ $ $
5 $ $ $ 2 $ $ $ 7
4 $ $ 5 $ 1 $ $ $
$ $ 9 6 $ $ $ $ $
3 $ $ $ $ $ 4 2 $
$ 7 $ 3 6 $ $ $ $
$ 4 $ 8 $ $ 6 $ $
$ $ $ $ $ $ 9 7 8

$ 6 $ $ 7 8 $ $ $
$ 9 $ $ 4 $ 6 $ 5
4 1 $ $ 5 $ 9 $ $
$ $ $ 8 $ 7 $ 1 $
$ $ 7 $ $ 1 $ $ 6
3 $ 1 $ $ $ $ 7 9
$ $ 5 $ $ $ $ 9 8
$ $ $ 7 8 9 $ $ $
8 $ 9 3 $ $ 4 $ $

3 $ $ 8 $ $ 5 $ 4
$ 7 $ 5 $ 6 $ $ 1
6 $ 5 $ $ $ $ $ 7
$ $ $ $ $ $ 9 7 $
$ $ $ $ 3 $ 1 4 $
4 2 $ $ 8 7 $ $ $
$ $ $ 4 $ 2 $ 1 $
$ $ 3 $ $ $ $ 2 $
2 6 4 $ $ $ $ $ 9

3 1 $ $ $ $ 5 6 $
$ 7 $ 5 4 $ $ $ $
$ $ $ 2 $ $ $ 9 $
5 $ 6 $ $ 4 $ $ $
$ $ 9 $ 3 $ $ $ 2
$ $ $ 9 $ $ $ 5 3
$ $ $ 4 $ 2 $ $ 5
$ $ $ $ $ 8 4 $ $
2 6 $ $ $ $ 7 $ $

$ $ $ 7 8 $ 4 6 5
$ 9 7 4 $ $ 1 $ $
$ $ 4 $ $ $ 7 $ $
7 8 9 $ $ 2 $ $ $
$ $ $ $ 7 $ 6 $ 4
4 $ $ $ $ 1 $ 8 $
$ $ $ 2 1 4 8 $ $
9 $ $ $ $ $ $ 4 1
1 4 2 $ $ $ $ $ $

9 $ $ $ 6 $ $ 4 $
$ $ $ 2 $ 4 $ $ 9
$ 4 $ $ $ $ 3 5 $
7 8 $ $ $ $ $ $ 3
$ $ $ 9 $ $ $ 2 4
$ $ 6 5 $ 1 $ $ $
$ $ 1 $ 8 9 $ $ $
8 $ 7 $ $ $ 1 $ 2
$ $ $ $ 2 $ 7 $ $

$ $ $ 4 $ 6 $ 1 $
$ 3 $ $ $ $ $ 4 5
$ 6 $ 1 $ $ $ $ $
$ $ 7 $ 4 2 $ $ $
$ $ 3 $ $ 8 2 6 $
$ $ 4 5 $ $ 8 $ $
2 $ $ $ 9 7 $ $ $
$ 7 $ $ 6 $ 4 $ $
3 $ $ $ $ $ 7 8 9

1 3 2 $ $ 8 $ $ $
7 $ 8 $ $ $ 1 $ $
$ $ $ $ $ 2 7 8 $
$ 8 $ 6 $ 4 $ $ $
$ $ $ 9 $ $ $ 4 2
6 $ $ 5 $ $ $ 7 $
$ $ 1 $ 7 $ $ $ 5
$ $ $ $ 5 6 2 $ $
3 5 $ $ 4 $ $ $ $

$ $ $ $ $ $ 5 3 $
9 8 7 $ $ $ $ 4 $
$ $ $ 6 2 4 $ $ $
$ $ 8 1 $ 2 $ $ 6
$ $ 5 $ $ $ $ $ 3
$ $ $ 4 6 $ $ $ 9
$ $ $ $ $ 1 3 6 $
$ 5 $ $ 7 $ $ $ $
2 4 $ $ $ $ 8 $ $

